#################
#F....I#....E..B#
#.####.#.####.#.#
#...R#.#...##.#.#
####.#.#.#.#.R..#
##.#.#...#.#.#.##
##.#.#####D#.#.##
#.S#.....#.#.#.##
#.##.#.#.#.#.#.##
#....#.#.#.#.#..#
#.####.#.#.#.##.#
#.F...B#...C....#
#################